WWWWWWWWWWWWWWW
WP    BBB BBBBW
W W W W W W W W
W R   R   B B W
WBW W W W WBW W
W R Y   Y  B  W
W W W W W W W W
WB   B   B R  W
WBW W W WBW W W
W    YBB   B BW
W WBW W W W W W
W   Y    B   GW
WWWWWWWWWWWWWWW