WWWWWWWWWWWWWWW
WP    BBB BBBBW
W W W W W W W W
W   R R   B B W
WBW W W W WBW W
W   R    R  B W
W W W W W W W W
WB   B   B    W
WBW W W WBW W W
W R  YBB   B BW
W WBW W W W W W
W  R     B   GW
WWWWWWWWWWWWWWW